MMMMMMMMMM
MM       M
M M      M
M M M    M
M M   M MM
M   M M  M
MMM M    M
M        M
M M  M M M
MMMMMMMMMM
