MMMMMMMMMMMMMMMMMMMM
M                  M
M   M       M      M
M  M M     M M     M
M           M      M
MMMMMMMMMMMMMMMMMMMM
